		Dcddffdbbacabcbdfafac = "adjacent" ++ "station";
		Fecafaebaefffbcdbefaaccfdeb = "affiliation";
		Ebdbebedbffafbecdacbda = "after" ++ "a" ++ "work" ++ "by";
		Dfeceaeefddcedbedfaaffceaf = "airline" ++ "hub";
		Cbcddbddcddeecefaccaebfedad = "allegiance";
		Fefcedbeeedfdedeefcbdbcbcfbef = "architect";
		Dbabfdacebafddbfdbcba = "architectural" ++ "style";
		Daffdabdabeaabfecafc = "archives" ++ "at";
		Eacacacaeaadbcfebecdbb = "author";
		Fdecfcedaafcfae = "award" ++ "received";
		Fccbcdddcacdfcfebfaab = "backup" ++ "or" ++ "reserve" ++ "team" ++ "or" ++ "crew";
		Bdfcfbceafabaedecbffdcadbac = "based" ++ "on";
		Dcafaacafbcbdaccdcfeabbbce = "basin" ++ "country";
		Ceedacdeddabeaccecdbeceecfcdad = "board" ++ "member";
		Ddcbcfdacbacdcdfcbcbcbafdbaacccbd = "broadcast" ++ "by";
		Dfdbbcfdadeecfacbcdccead = "canon" ++ "ization" ++ "status";
		Bdefbcdcfbeebcdefdbdc = "capital";
		Abdfacdacdbbbfbadabfefdbc = "capital" ++ "of";
		Edfafaeededabfdebebcebcbcdb = "carries";
		Eddbcfaadaeeaacfcffadcbbcdcf = "cast" ++ "member";
		Caeadfeceaccfcfdadbeb = "cause" ++ "of" ++ "death";
		Ecbcacaacdafcabcaaecfa = "chair" ++ "person";
		Dffddbebafcdddbfbfbaddbfccda = "characters";
		Aedcadbadadacbdfdcedbaacad = "chief" ++ "executive" ++ "officer";
		Ddcecefadacedeaebbda = "child";
		Aaacfbcbccdfcedfcaefdfdadfeef = "commander" ++ "of" ++ "(" ++ "DEP" ++ "REC" ++ "ATED" ++ ")";
		Ccafecabcbcbbaaedebfdeb = "composer";
		Faedadbdceceecdfcecffeecdaa = "conflict";
		Edddafddffdcffdccdcaacdb = "connecting" ++ "line";
		Cdcccbdcdeddefcffbbcfcefda = "connecting" ++ "service";
		Bacebdfabbdbafcaebbdefcae = "contains" ++ "settlement";
		Cbbfaffdfeebaeabcbcdfbf = "continent";
		Affefdbdcbadabddfcdcadcfaef = "country";
		Dbbdfaabdbfcadfddfdfeccce = "country" ++ "for" ++ "sport";
		Dffaecfcffecefdeecfbbcddcbaa = "country" ++ "of" ++ "citizenship";
		Cdefdccadaccefdcaf = "country" ++ "of" ++ "origin";
		Ecadccbeeeccccffcceeebffedcc = "cover" ++ "art" ++ "by";
		Bcbfdebdcabfdefdeebbaacdad = "creator";
		Ddfdfcdeccedebbbdbcccbbbbff = "crosses";
		Fffdfbcacddcbadcfabbccddfc = "culture";
		Cbdfccccefcfcdcdaaccdd = "dedicated" ++ "to";
		Afdeacbacafeabfdececcfdb = "described" ++ "by" ++ "source";
		Dbfadafabafaffbcaadaffca = "designed" ++ "by";
		Fcbdaffdbedacabafbddfbf = "di" ++ "ocese";
		Efdcabfbedbcdcdfddbabcefbae = "director";
		Abcdccdadaaaaedbadca = "director" ++ "of" ++ "photography";
		Ffdabeccdbbdfcdcaeafcebfb = "distributed" ++ "by";
		Dfeadfdbebcdcafcabdadaccde = "doctoral" ++ "advisor";
		Cebcfbdcabeccdacfedddd = "doctoral" ++ "student";
		Dcabacacffcddabafcddcddbcacff = "drafted" ++ "by";
		Cecbbedefafdfffdabcccbfdcc = "educated" ++ "at";
		Efdfcbeeadebccacacecc = "employer";
		Ecbccbccbaaedfcacabcdccf = "ex" ++ "clave" ++ "of";
		Dfdfacfbdceafbbbd = "executive" ++ "producer";
		Daabaaadacdaedbcdefeebb = "family";
		Afcfdaefcdbeddfbcca = "father";
		Fcddbddecccecaabefafbc = "film" ++ "crew" ++ "member";
		Bbffadccbdaaafbbacca = "film" ++ "editor";
		Eadcaddacdedcdeaabbd = "filming" ++ "location";
		Deceffdcaffeffebafadb = "followed" ++ "by";
		Deafadfafadfdacdbafdaacc = "follows";
		Eaeefeaeccceeeeeafdfddb = "founded" ++ "by";
		Dbbcdfebeadacacbcacdeadacbc = "genre";
		Afdacfeebcedeafbefadddb = "has" ++ "part";
		Adfbcfcdfbdfbaacbe = "head" ++ "coach";
		Cadacefcadaedd = "head" ++ "of" ++ "government";
		Bfcddedcffbffbdcdccfaeac = "headquarters" ++ "location";
		Efebdcafffbddcadebabfb = "heritage" ++ "designation";
		Addeecbcfcedbfcbfcde = "highway" ++ "system";
		Edfdcaacbfbfdfbb = "home" ++ "port";
		Abfceedfebcfcedbeddaccebdbfeaf = "illust" ++ "rator";
		Affaeccdbffeceff = "infl" ++ "ows";
		Daacdecbcabeddcbccccfdbb = "influenced" ++ "by";
		Cbabeeabdeacfdedfbffafacadcffa = "killed" ++ "by";
		Bbaecebecddfdbbdddaaebaaaf = "lake" ++ "out" ++ "flow";
		Afdeddacbabeeefad = "language" ++ "of" ++ "work" ++ "or" ++ "name";
		Dcfcedabcaffdffccbe = "languages" ++ "spoken" ++ "," ++ "written" ++ "or" ++ "signed";
		Ddfedcdbadabbcdbebc = "lib" ++ "rett" ++ "ist";
		Febcdbdbbbaceabfcfeef = "located" ++ "in" ++ "or" ++ "next" ++ "to" ++ "body" ++ "of" ++ "water";
		Cdbfffadaebcfebacadabbceceb = "located" ++ "in" ++ "protected" ++ "area";
		Fdbbdfbbccffeadafbcccdadf = "located" ++ "in" ++ "the" ++ "administrative" ++ "territorial" ++ "entity";
		Bcfdeefaeffadfadbfeaeadefc = "located" ++ "on" ++ "astronomical" ++ "body";
		Fabaffccafffcbacefeca = "located" ++ "on" ++ "linear" ++ "feature";
		Ddaffaabdacefefceceeafaab = "located" ++ "on" ++ "street";
		Deffcdfdcfabbbdddfdcf = "located" ++ "on" ++ "terrain" ++ "feature";
		Eeaeaeebdfbeabefbacbbcce = "location";
		Cdeffdbbfbcaaaddeccedefebcbe = "location" ++ "of" ++ "creation";
		Afdfaafcfbbbffefcebbbef = "location" ++ "of" ++ "formation";
		Eeeaaffeefcdbffbfaaffbfbccbd = "lowest" ++ "point";
		Eadfdbedbafaedbafdababea = "lyrics" ++ "by";
		Dbfbfcdecacccdecabadadbabb = "main" ++ "building" ++ "contractor";
		Eaeedfbdcdffcedbcabdeae = "main" ++ "subject";
		Accbeeaacdadcdecdbeffcedf = "maintained" ++ "by";
		Acedbcbefaaeccdacefcabfe = "manufacturer";
		Adceefabebedccdcc = "member" ++ "of";
		Ebbdfdbbcdbcebcbcaeaeefaafce = "member" ++ "of" ++ "political" ++ "party";
		Fdcdfeeadffbaeaecddff = "member" ++ "of" ++ "sports" ++ "team";
		Dcdbcabcbfebbbbfabddebfd = "military" ++ "branch";
		Eeddbfecffbbdfcefcaafcaeabdeda = "mother" ++ "house";
		Aedfadeffeccbeeebbeac = "mouth" ++ "of" ++ "the" ++ "water" ++ "course";
		Aeabecebaedacfcfeedfca = "movement";
		Ecbfffaaabeafacbacfeea = "named" ++ "after";
		Eebaecdbcaceeebfcfdda = "narrative" ++ "location";
		Eecdbddcadedeeebaffafa = "narrator";
		Eecfbfadbefcbcadcfceaeeb = "noble" ++ "title";
		Fcbcfbedcbeadcfcfecaaee = "nominated" ++ "for";
		Feccfceaeeeedccbddccbbeaf = "notable" ++ "work";
		Fdfcebdabedefaacadaed = "occupant";
		Dffdfcedcbcadfdcfedd = "occupation";
		Ebfbbeabcfceccfedabebffef = "operator";
		Dddfcdbfcadddecdfdffccfe = "origin" ++ "of" ++ "the" ++ "water" ++ "course";
		Bdfeafbbffdbbbefbccedcbefac = "original" ++ "broadcaster";
		Acdfaeadeafdcbaddaedcdcadb = "original" ++ "language" ++ "of" ++ "film" ++ "or" ++ "TV" ++ "show";
		Fcebbebdeeabeccfecebcbfa = "owned" ++ "by";
		Dbbaaaeabeadfeffc = "parent" ++ "organization";
		Feaeeaddfebefdfdfcdcbfbf = "part" ++ "of";
		Bfcbabdedbfaaaaaceeadffb = "part" ++ "of" ++ "the" ++ "series";
		Ccdeeefcccfdadaacbabddba = "participant";
		Aeadbedcdcbafcbceedeafeabecf = "participant" ++ "in";
		Badefbdaaccfeaebcabaeacf = "partner" ++ "in" ++ "business" ++ "or" ++ "sport";
		Eeddcacdbfebebfaddaafbdcfadeddf = "patron" ++ "saint";
		Fbecbabebddffebdadbb = "performer";
		Ffadedcddefdecedcadaa = "place" ++ "of" ++ "birth";
		Deccddbcacdbcceeecda = "place" ++ "of" ++ "burial";
		Bcfadccfeffbfaba = "place" ++ "of" ++ "death";
		Fddefcfbdffaffcaabbaedfadabfb = "place" ++ "of" ++ "detention";
		Effbcfbfcbbecffffaaffdeff = "place" ++ "of" ++ "origin" ++ "(" ++ "Sw" ++ "itzerland" ++ ")";
		Fcddaceebceacceecaedacfbdeb = "place" ++ "of" ++ "publication";
		Aefdffaffdfcaedaebcfacbedce = "place" ++ "served" ++ "by" ++ "transport" ++ "hub";
		Abaebfcdcedeebcbcbcdfdaf = "position" ++ "held";
		Aaaadadfbeeffeaceeeacfec = "presenter";
		Dfaffebedaccddfdcaaafeedabfcdb = "producer";
		Eedafdbdaefdcfefc = "production" ++ "company";
		Afeeceddddbabaaeccfcaebbafbce = "production" ++ "designer";
		Fabebdcbfcbdecbdafcacba = "publisher";
		Cfdbffddefefbccdfdbbbefdbcdcabbf = "record" ++ "label";
		Decaabaefdaebfcfdfcaabcced = "recorded" ++ "at" ++ "studio" ++ "or" ++ "venue";
		Ddefdedacaedaebeacdfaf = "relative";
		Dbcaecaefececdcbdfdbdccc = "religion";
		Beddebfddcceeecdbdceeedc = "religious" ++ "order";
		Dbfbbfbcaababafcadaecffaeaeaafda = "residence";
		Abebaadfdddccedbecfffeda = "screen" ++ "writer";
		Abafedabbbeffddacfcfdcedbfc = "shares" ++ "border" ++ "with";
		Ddeedcafdfefbbaffbdcbfbbffe = "sibling";
		Eceacbccbeedfaacbdcdd = "sport";
		Fbececebfbfeabdbebcdbaece = "spouse";
		Aadecbabaecddfbeeb = "stock" ++ "exchange";
		Ccbfcaebddcfcafcdbccaabb = "student";
		Ebedfeedecfefaeabcfebaffaf = "student" ++ "of";
		Beaeadcbfccfafadaebffa = "subclass" ++ "of";
		Defaceabeebaaabdeceecbde = "subsidiary";
		Aacdafbfcecafefebbdabf = "termin" ++ "us" ++ "location";
		Ebfbeeeddcaeaebc = "time" ++ "period";
		Daddbfaadfcbfffdedbf = "twin" ++ "ned" ++ "administrative" ++ "body";
		Dababaedaecebccfecbea = "unmarried" ++ "partner";
		Bcabedadfdfdbcdddfcffdabb = "voice" ++ "actor";
		Afcdfbfddcafcdbeadffffabdba = "winner";
		Abfcaecabfffbebeceecfdba = "work" ++ "location";